#,#,#,#,#,#,#,#,#,#
#,O,O,O,O,O,O,O,O,S-5
#,O,#,#,#,#,#,#,#,#
#,O,O,O,O,O,O,O,O,#
#,#,#,#,#,#,#,#,O,#
#,O,O,O,O,O,O,O,O,#
#,O,#,#,#,#,#,#,#,#
#,O,O,O,G-5,O,G-5,O,G-5,#
#,O,O,O,G-5,O,G-5,O,G-5,#
#,#,#,#,#,#,#,#,#,#